Давайте	Давайте
клип	клип
быстрее	быстрее,
пж	пожалуйста.

вы	Вы
в	в
курсе	курсе,
,	
что	что
у	у
нас	нас
у	у
всех	всех
открытые	открытые
акки	аккаунты.

подредачила	Подредактировала
и	и
вернула	вернула
одну	одну
скрытую	скрытую
ранее	ранее
работу	работу
на	на
фб,	Фейсбуке,
ура	ура.

опять	Опять
на	на
работу	работу,
пиздос	ужас.

@flabellata	@flabellata
жададада	да-да-да.
блять	

@Veria_di	@Veria_di
@Tobibae5	@Tobibae5
ЧЕГО??	чего?
ТЫ	Ты
ТАКАЯ	такая
БОГАТАЯ??	богатая?

Хочу	Хочу
дожить	дожить
до	до
нг	нового года
2100-ого	2100-ого
года.	года.
